1111111111
1000012001
1111011011
1000000001
1011011011
1000010001
1011011011
1010010011
1301011011
1111111111