11111111111111111111
12111111111011000111
10000001100001110111
11111101101111110111
11011101101110000111
11000000000000111111
11011101111010111111
11000001111010000011
11111111011010111011
11111000011011100011
11111011000011101111
11001010011110001111
11011010111110111011
11011010000000110011
11000011111110110111
11011010011000000011
11000010111110011011
11111110100000010011
11110000001110111031
11111111111111111111