1111111111
1201000101
1010010101
1000101101
1101001001
1001101011
1100001001
1110100011
1000011031
1111111111